11111111111111111111
1000C00C011100000001
11111111111111111111
10000000000000000001
1000000000000C000001
10P0000000E000000001
11111111111111111111
