111111111111111111111
100000000000000000001
100000000000000000001
1000000000C0000000001
100000000000000000001
100000001111100000001
1P000C0011E1100000001
111111111111111111111
111111111111111111111
