1111111111111
100C00CC00001
10E0011111001
1PC0111000011
1111111111111