1111111111111
100C00CC00001
1000011111001
1PC01110E0011
1111111111111