1111111111111
10000000000C1
1000011111001
10P011E001001
1111111111111