1111111111111
100000C0000C1
1000011111001
10P011E100011
1111111111111