1111111111111
11E1000000001
1C11000001001
10P1111000011
1111111111111