1111111111111
100000C0000C1
10E0011111001
11P11C0000111
1111111111111