111111111111111
10SR00DD0000001
100000d00000001
100000000000011
1dDEW0000000001
111111111111111
