11111111111111
1PCCE000000101
10000000000111
1000000000011
100000001111111
10000000000001
10000000000001
11111111111111
